NO ./assets/Horror_map/NORTH.png
SO ./assets/Horror_map/SOUTH.png
WE ./assets/Horror_map/WEST.png
EA ./assets/Horror_map/EAST.png

F 16, 16, 16
C 125, 0, 50

11111111111111            1111
10000000000111 111111111111001
111000000000011100000000000001
100000100000000000001111111111
100000000000011100000000000001
10000000000001 111111111111001
100000N0000001            1111
11111111111111