NO ./game/maps/big_map.cub
SO ./game/maps/big_map.cub
WE ./game/maps/big_map.cub
EA ./game/maps/big_map.cub
F 10, 255, 0
C 10, 0, 255

        1111111111111111111111111
        1000000000110000000000001
        1011000001110000000000001
        1001000000000000000000001
111111111011000001110000000000001
100000000011000001110111111111111
11110111111111011100000000001
11110111111111011101010010001
11000000110101011100000010001
10000000000000001100000010001
11110000000000001101010010001
1001000111010101111101111000111
11000111 1110101 1011110100N1
11111111 1111111 111111111111
