NO ./game/assets/children_map/Kinder_Motive1.png
SO ./game/assets/children_map/Kinder_Motive2.png
WE ./game/assets/children_map/Kinder_Motive3.png
EA ./game/assets/children_map/Kinder_Motive4.png

F 255, 0, 0
C 255, 10, 10

1111111111111111
1000000000000001
1000000111000001
1000000000000001
1000000000111001
1000000000000001
10000000N0000001
1111111111111111