NO ./game/maps/big_map.cub
SO ./game/maps/big_map.cub
WE ./game/maps/big_map.cub
EA ./game/maps/big_map.cub

F 0, 155, 0
C 100, 100, 100

11111
10001
10N01
11111