NO ./game/maps/big_map.cub
SO ./game/maps/big_map.cub
WE ./game/maps/big_map.cub
EA ./game/maps/big_map.cub

F 255, 0, 0
C 255, 10, 10

11111111111111111111  11111111111
10000000010000000001  10000000001
100000000100000000011110000000001
110000011110000000000000000000001
110000000000000001111110000N00001
  1000000000000001  1111111111111
  1000000001000001
  1000000001000001
  1000000001000001
  1111111111111111