NO ./game/assets/children_map/Kinder_Motive1.png
SO ./game/assets/children_map/Kinder_Motive2.png
WE ./game/assets/children_map/Kinder_Motive3.png
EA ./game/assets/children_map/Kinder_Motive4.png

F 255, 0, 0
C 255, 10, 10

11111111111111            1111
10000000000001 111111111111001
100001110000011100000000000001
100000000000000000001111111111
100000001110011100000000000001
10000000000001 111111111111001
100000N0000001            1001
11111111111111            1111